██████████████████████████████████████████████
██░░░░░░░░░░░░░░██████████████████░░░░░░██████
██████████████░░██████████████████░░██░░██████
██████░░░░░░░░░░██░░░░░░░░░░██████░░██░░██████
██████░░██████████░░██░░██░░██████░░██░░██████
██████░░░░░░░░░░██░░██░░██░░░░░░░░░░██░░░░░░██
██████░░██████░░██░░██░░██████████████████░░██
██████░░░░░░██░░██░░██░░░░░░░░░░░░░░██░░░░░░██
██████████░░██░░██░░██████████████░░██░░██████
██░░░░░░░░░░██░░██░░██░░░░░░░░░░░░░░██░░░░░░██
██░░██████████░░██░░██░░██████████████████░░██
██░░██░░░░░░██░░░░░░██░░░░░░██████░░░░░░░░░░██
██░░██░░██░░██████████████░░██████░░██████░░██
██░░░░░░██░░░░░░██░░░░░░░░░░░░░░██░░██████░░██
██████████░░██░░██░░██████░░██░░██░░██████░░██
██░░░░░░░░░░██░░░░░░██░░░░░░██░░██░░██░░░░░░██
██░░██████████████████░░██████░░██░░██░░██████
██░░░░░░██████░░░░░░██░░░░░░██░░░░░░██░░██████
██████░░██████░░██░░██████░░██████████░░██████
██░░░░░░██░░░░░░██░░██░░░░░░░░░░██░░░░░░██████
██░░██████░░██████░░██░░██████░░██░░██░░██████
██░░░░░░░░░░██████░░░░░░██████░░░░░░██░░░░░░██
██████████████████████████████████████████░░██
